{
  "width": 10,
  "height": 8,
  "tileSize": 64,
  "tiles": [
    [1,1,1,1,1,1,1,1,1,1],
    [1,0,0,0,0,0,0,0,0,1],
    [1,0,2,0,3,0,4,0,0,1],
    [1,0,0,0,0,0,0,0,0,1],
    [1,0,0,0,5,0,0,0,0,1],
    [1,0,0,0,0,0,0,0,0,1],
    [1,0,0,0,0,0,0,0,0,1],
    [1,1,1,1,1,1,1,1,1,1]
  ]
}
